0 0
####################
#                  #
#   1     2     1  #
#                  #
#                  #
#    B   BB        #
#  2 B             #
#    B             #
#        BBBBB     #
#                  #
#                  #
#                   
####################
    2 2
####################
    2 2 2 2
####################
    2 2 2 2 2 2 2 2
####################